################
#      @       #
#              #
#      o       #
#      X       #
#      o       #
#              #
#     S        #
#              #
#              #
#        D     #
#              #
#              #
#              #
#              #
################
