################
#           #  #
#           #XX#
#  s        #  #
#              #
#     d        #
#              #
#  s       d   #
#             G#
#              #
#              #
#              #
#        C  C  #
#C             #
#C     @      C#
################
